a : b 
b : c d e 
c : 
d : c 
e : d c 
f : j 
g : h i 
h : i 
i : 
j : g 
k : l m 
l : 
m : l 
n : o 
o : k 
p : v 
q : s 
r : p 
s : 
t : s q 
u : r t 
v : q t 
w : bg 
x : bj bh 
y : x 
z : bj bk be 
ba : bd bf x 
bb : x bh y 
bc : w bi be bf z 
bd : bc bl 
be : bk bj bf 
bf : y bg w 
bg : y bi bh 
bh : 
bi : bb 
bj : bh 
bk : bi bb y w bf 
bl : z be bg bc 
bm : bx cb cn cz 
bn : ds 
bo : di dk dl 
bp : bv 
bq : da ck di 
br : bs dm bn cb 
bs : cq 
bt : da dm bn br 
bu : bp co dp cw dt 
bv : 
bw : dr cw 
bx : br dn bt 
by : bz bu cv dv cz dt cs cy ce 
bz : ck cf cp ch co dm 
ca : cb bz bt bx 
cb : db dv ds bn 
cc : cm 
cd : dr cw cu dq cj 
ce : dl cs dj cy 
cf : bs dk 
cg : cp co ch ce cy dq by 
ch : ci dv 
ci : dl bo 
cj : dk db bx dr dq 
ck : bv do dd 
cl : dn di bo ci dm 
cm : dm df ch 
cn : bt br bx ch ca 
co : dv dd ch cl 
cp : ci ct cl 
cq : bv bp 
cr : bm cv cw cz 
cs : cr dp dh bu 
ct : dv da de 
cu : bt cl dr bw 
cv : bz 
cw : bx bm cz 
cx : bp br ck cw cr 
cy : ct ck du 
cz : ci ca cn 
da : dk cq dd cf ck 
db : dn bq di 
dc : dr cj cd 
dd : do cf 
de : bo co cl 
df : bw cu cd dc cj 
dg : bo cc dr 
dh : dg 
di : ck cf dd da 
dj : dh 
dk : dn bp 
dl : db cq 
dm : bq di ch 
dn : bs 
do : dk cf 
dp : ci bt cr dq dj 
dq : ds bw cp cu 
dr : cp cr cq cz cx 
ds : da de bz cv 
dt : dh cc dj dp 
du : cb cs bu 
dv : ci dd 
