a : b 
b : 
c : b a 
d : b a c 
e : c d 
f : j 
g : i 
h : g 
i : 
j : i h 
k : m 
l : k n 
m : 
n : m k 
o : l k 
p : 
q : v 
r : u p 
s : q 
t : r 
u : p 
v : t u 
w : bl z bc 
x : bi bk bg bf 
y : bf bb 
z : bl 
ba : 
bb : bh bg x bf 
bc : z 
bd : bb x y 
be : bl w 
bf : bc bk bi be bg 
bg : bj bh bk bi 
bh : bc w bj 
bi : ba z bh bk 
bj : w be ba 
bk : bh 
bl : ba 
