a : b 
b : 
c : b a 
d : b a c 
e : c d 
f : i 
g : f 
h : g i 
i : 
j : i g h 
k : l o n 
l : o 
m : n k 
n : l o 
o : 
p : v u r 
q : p 
r : u s 
s : v 
t : 
u : s 
v : t 
w : 
x : bl bg 
y : ba w be 
z : ba bf 
ba : bi 
bb : bd 
bc : bi ba z bb bj 
bd : x w 
be : bd bc bk 
bf : bi ba 
bg : bh bk 
bh : bf ba z 
bi : w bl 
bj : bb bk 
bk : bl bh 
bl : w 
