a : b 
b : 
c : b a 
d : b a c 
e : c d 
f : b h i 
g : f d e 
h : b 
i : j b h 
j : h 
k : o 
l : k 
m : k l 
n : 
o : n 
p : r 
q : p v t 
r : 
s : v t q 
t : v 
u : p 
v : u 
w : bc 
x : bl bh bk 
y : bh w 
z : bl bk bg bc x 
ba : w bg 
bb : bl bd z 
bc : bh 
bd : bl 
be : bd bg 
bf : ba y 
bg : bc w y 
bh : 
bi : z bb bj 
bj : bb 
bk : y be 
bl : bf ba bg y 
bm : bq 
bn : 
bo : dc ct bn 
bp : 
bq : cj 
br : bz 
bs : 
bt : 
bu : br bs 
bv : cn ch 
bw : dq 
bx : ds 
by : de 
bz : bv da 
ca : de 
cb : 
cc : 
cd : cy cq cj 
ce : 
cf : cd bn di 
cg : dm br 
ch : dv db 
ci : bp 
cj : 
ck : 
cl : ci 
cm : 
cn : dj 
co : cl dd 
cp : 
cq : cn dn 
cr : 
cs : cl 
ct : 
cu : ct 
cv : ca 
cw : bs cl ch 
cx : 
cy : cc do cs 
cz : cx ci 
da : bm 
db : dj 
dc : 
dd : 
de : ce 
df : 
dg : 
dh : db dr 
di : bu dt 
dj : 
dk : cq 
dl : cj 
dm : ct cu 
dn : 
do : cz 
dp : 
dq : 
dr : dl cw 
ds : 
dt : br 
du : dh 
dv : 
