a : b m s r y co by ck dj cg dp bx 
b : d c h e o u r cg ds 
c : d e j q ca bz 
d : g w cb 
e : d o n u cb 
f : j 
g : k 
h : e f i bf 
i : c a w cj bo 
j : d l s bd 
k : i bf bc 
l : h dn dh 
m : e l bc bh dk 
n : j g c o t v bf cs cc 
o : d c bc cr du bo 
p : bk dg bn 
q : k d s u 
r : h g c e z dr do cn 
s : t v o h cx bt bv bw 
t : p v cn 
u : f g s d bf 
v : p bj cm bn dk ct 
w : p f 
x : bj bb db ca 
y : ba j d e 
z : bk ba 
ba : bj be dd br 
bb : bl be z bp dn 
bc : l 
bd : o h bt cc 
be : ci ck 
bf : bk p cs 
bg : bb x bt ca dr cr 
bh : n k br dv cm 
bi : bg cv br 
bj : be cx 
bk : ba do ci dd 
bl : bk bj z cz 
bm : bk ba co cm 
bn : r cv 
bo : cv dc l 
bp : by cx 
bq : cd do dh dp 
br : co cv 
bs : bi bc 
bt : cs cj cx z bf cc 
bu : ce cq dl bx 
bv : db cy ck 
bw : bv co ct 
bx : cq dt dl 
by : bm cx 
bz : bm cd i d 
ca : dn co bt bf bd 
cb : de 
cc : cm dn bf 
cd : f i g 
ce : f cd cq 
cf : bx ch bo a b 
cg : bs cx bn q bu ck dj 
ch : bk dr cc 
ci : cj w 
cj : dd w do 
ck : cc ca 
cl : a 
cm : ci dd bj cx 
cn : bc y 
co : dd bk cv 
cp : br s b dq 
cq : bz e dt 
cr : br bm da 
cs : do cm bh bb 
ct : bl dd dr db t r bn 
cu : da m 
cv : dd bk 
cw : dk cb bz ce 
cx : bl 
cy : q da 
cz : bs cj 
da : bs ch 
db : cr ck bg 
dc : n du 
dd : w 
de : cd g 
df : f ck dt cw bq 
dg : dr bw s 
dh : ct dk v n 
di : bu bk dm bv bq 
dj : t bu dl 
dk : cn t bn ct 
dl : bj q df dc 
dm : m d ce df cg cp 
dn : bp cm bh z 
do : dd w 
dp : bs dv j dc cb dt d ce cw 
dq : dh m cq cl cf b 
dr : be ca cx 
ds : h j cl bz 
dt : j de e bz 
du : l cu m 
dv : bp ci 
