a : 
b : a c d 
c : a e 
d : c e 
e : a 
f : g i 
g : h j 
h : 
i : g 
j : h 
k : m 
l : k 
m : o 
n : m l 
o : 
p : r q u 
q : u 
r : 
s : v 
t : p 
u : r 
v : t 
w : z bg bh 
x : bd y 
y : ba 
z : bl bg 
ba : bd w 
bb : x bg bh 
bc : ba bf z bl bk 
bd : be 
be : bg 
bf : bh bb 
bg : 
bh : bg be bd 
bi : bd bj 
bj : bc bk 
bk : bh bl bd bb bf 
bl : bd bh 
