a : c b 
b : d c 
c : e 
d : 
e : d 
f : 
g : f j 
h : f j g i 
i : j g f 
j : f 
k : m l o 
l : m 
m : 
n : o m k 
o : l 
p : r 
q : u v s 
r : 
s : u p 
t : p 
u : t 
v : r u s 
w : bj bg bf 
x : bg bk bi 
y : be ba bh bc 
z : bd bc y 
ba : bf bb 
bb : w bl 
bc : bl bh 
bd : bb bj ba 
be : bg bf bb bd 
bf : bj bl 
bg : bk 
bh : bf be ba 
bi : bj z y 
bj : bk bg 
bk : 
bl : bg bj 
