a : e b 
b : d 
c : a 
d : e 
e : 
f : h b 
g : i 
h : 
i : h 
j : h c 
k : m o l 
l : m 
m : n 
n : 
o : m l 
p : s q 
q : u r 
r : u v t 
s : t 
t : 
u : v 
v : s 
w : bk bl 
x : be bi z ba 
y : be bf bj z x 
z : bk bf bb be 
ba : bi bl bg w 
bb : w ba 
bc : be bi bj 
bd : bf 
be : 
bf : bk bi 
bg : bf bd 
bh : bf x bj y 
bi : be 
bj : bi 
bk : bj be bc 
bl : be bd bg bc 
