a : e b 
b : d j 
c : a 
d : e 
e : f 
f : 
g : f h 
h : i 
i : f 
j : e 
k : l 
l : o m 
m : o 
n : m k o l 
o : 
p : v 
q : r 
r : 
s : r v p 
t : u s 
u : p s 
v : r q 
w : bc 
x : bd bg z 
y : z bi 
z : bk 
ba : bl 
bb : w bc bi bf 
bc : y 
bd : bj bh 
be : w bb 
bf : x bg bc w 
bg : ba 
bh : bg 
bi : ba x 
bj : bh ba 
bk : bg bj bd 
bl : 
