a : b d 
b : e 
c : e b 
d : c b 
e : 
f : h 
g : j 
h : i 
i : 
j : f 
k : n l 
l : m o 
m : 
n : m 
o : n 
p : u 
q : v 
r : p 
s : q 
t : p r 
u : 
v : p t 
w : bj bk 
x : w be bf 
y : bi 
z : bg bi 
ba : bc bb 
bb : z bc 
bc : bj be bd w x 
bd : bh y bk bf z w x 
be : bl w z 
bf : be y bg 
bg : bl 
bh : bi be x 
bi : 
bj : z bk 
bk : bi y 
bl : y bk 
