a : e b 
b : d h 
c : a 
d : e 
e : g 
f : 
g : 
h : i 
i : 
j : b 
k : n m 
l : 
m : l 
n : l m 
o : k 
p : u q 
q : s u 
r : s 
s : 
t : q u p 
u : v 
v : r 
w : ba bg bi x 
x : y bj bi 
y : bh bb bg ba 
z : bl bj 
ba : bj bc bk bg 
bb : bk be bc bf 
bc : bl bd 
bd : be bl 
be : bh 
bf : bc bg ba 
bg : bj bk 
bh : 
bi : bj bk bg y 
bj : bc 
bk : z bh bd bj 
bl : bh be 
bm : db cc cs 
bn : dr dt dv 
bo : dk cz dq cp 
bp : ct cx cm 
bq : cu ct bo 
br : 
bs : ce dc cz cq 
bt : cp dl 
bu : 
bv : 
bw : dm bs du 
bx : cq ch 
by : 
bz : bp 
ca : ds 
cb : dn cu 
cc : bt cv dp ct 
cd : cb dr df bv de 
ce : do 
cf : bn dk de 
cg : bt dj 
ch : cx 
ci : dk dv cl 
cj : by cp 
ck : 
cl : db dd cm cx 
cm : cf 
cn : dv cd dt 
co : dr 
cp : bv 
cq : ce 
cr : bz dj dg de bo cf 
cs : ci cg 
ct : da cw 
cu : br 
cv : cw bw 
cw : cj cz 
cx : df bs cj 
cy : bp by ci 
cz : da 
da : cu bu co by 
db : ck bn bz 
dc : df co 
dd : cb di 
de : ck 
df : dg 
dg : co 
dh : cw ce 
di : cx da du 
dj : db ca 
dk : dh bu cb du da 
dl : dc cw di 
dm : dn dq ct cn 
dn : 
do : cd bv ck 
dp : du cl 
dq : br dh dk bx 
dr : cb 
ds : di 
dt : ca bq 
du : cu cx cq cp 
dv : dk bt 
