a : e b 
b : d j 
c : a 
d : e 
e : f 
f : 
g : f h 
h : i 
i : f 
j : e 
k : o 
l : k 
m : 
n : m 
o : n 
p : s v 
q : u 
r : s p v 
s : v 
t : v p r 
u : t 
v : 
w : ba bf x 
x : ba y be 
y : bi z bj 
z : bb bi 
ba : bj y 
bb : bi 
bc : be x 
bd : z bj y bh 
be : bd bh 
bf : bc z bh 
bg : bh x bd bc w 
bh : bj bi y ba 
bi : 
bj : z bb 
bk : bc bf w bg 
bl : z bk bg 
bm : cp bs cs 
bn : bz cf bx 
bo : ca ct 
bp : cd dd db 
bq : bo 
br : cq cm dt 
bs : cq 
bt : dq do bw 
bu : bv do dg 
bv : bw bq du bt 
bw : cd bn ct dg 
bx : cw dn db bp 
by : cx bz dh bn 
bz : db dh 
ca : cg da ct 
cb : dr br 
cc : dr ds cr 
cd : dq 
ce : ch cg 
cf : dn bz 
cg : dv by dd bp bx co 
ch : cx 
ci : ce dj cf 
cj : cy dj dm ch dk dl 
ck : cq di 
cl : cb de 
cm : dv dr dd dt 
cn : ds dk dg 
co : cm bn dh by 
cp : bs 
cq : 
cr : bw bz bx bo dc 
cs : cq bs cp 
ct : ci da 
cu : dg bt bu 
cv : bu ci cz 
cw : cd dp dn 
cx : cb cs dt 
cy : cu cv 
cz : dp do bw cu 
da : co cf bn ck ce ci 
db : cw dn 
dc : bq bm cy 
dd : bm dr 
de : cy ce cn 
df : cs bm 
dg : ca du do 
dh : cx bp bx 
di : cx ch 
dj : dp db ce co 
dk : da cp df cr cc 
dl : df cz dm 
dm : cs bq bt cl dk 
dn : dq cd 
do : br dt bq du 
dp : di ch ck 
dq : dp bs 
dr : dv 
ds : bo br bq 
dt : cq dd 
du : ds 
dv : df bs 
