a : e b 
b : d j 
c : a 
d : e 
e : f 
f : 
g : f h 
h : i 
i : f 
j : e 
k : l 
l : n o 
m : l k 
n : o 
o : 
p : v r u 
q : p r 
r : t s 
s : t 
t : 
u : v 
v : t s r 
w : y bf 
x : bg bf 
y : z 
z : bc bg bb 
ba : bi be 
bb : bh bj 
bc : x bj 
bd : bl w 
be : bh w bi 
bf : 
bg : bf 
bh : x bc 
bi : bd y 
bj : x 
bk : z ba 
bl : x w 
bm : bw dd 
bn : bt bz cm bo 
bo : cn bq 
bp : cp bm cb 
bq : 
br : dc bt dp 
bs : dt cv bv cy dq 
bt : bp 
bu : bq cv dl cd by 
bv : bm 
bw : dt cp cg cf 
bx : dm cu bu cd by 
by : cz cv ci bo bs ch cd dl 
bz : cb cg de br db 
ca : br dj di cs by 
cb : dr dg bv 
cc : db cw dv ce cl ch 
cd : bm cl bs di 
ce : cr dd 
cf : du dd 
cg : cp 
ch : cl co cz 
ci : bm dp da 
cj : dc co dm 
ck : dc dk 
cl : dr cp ce ck 
cm : bw dc ci bz bo 
cn : dr bz 
co : ct da bo 
cp : dg df du 
cq : dg cg dd 
cr : ci dh 
cs : bx cl da cm do 
ct : dv bo 
cu : bq 
cv : cc 
cw : dc bn bp co cz 
cx : dr dv cj cs co do ca 
cy : bp ci 
cz : ct dq cm co 
da : bq cg bv 
db : bt dr 
dc : cu bv cy de 
dd : df 
de : cy 
df : bq du dj 
dg : dj df cf 
dh : dn cz 
di : dq ch bs 
dj : cu bq du 
dk : dm ce dh de cj 
dl : di bp dn cy cd 
dm : cz bw ce 
dn : ci cw dv 
do : dv cm ch dl bx 
dp : cb dd db 
dq : bm bt cy bo co 
dr : bm da 
ds : cq 
dt : ds df bq cf 
du : cu 
dv : cb bn da 
