a : b d 
b : e 
c : e b 
d : c b 
e : 
f : j g h 
g : j 
h : g 
i : f h 
j : 
k : l 
l : 
m : k o 
n : k m o 
o : l k 
p : q 
q : u 
r : p u 
s : q r 
t : r v 
u : 
v : q s p r 
w : ba 
x : ba bc w bk 
y : bb 
z : bf 
ba : y bf 
bb : z bf 
bc : ba bk 
bd : bc w bi 
be : bc x bg bl 
bf : 
bg : bh bf bd w bk bl 
bh : z w bk bi bd 
bi : y bj 
bj : bc x 
bk : w 
bl : w x bj bh 
bm : bs dm dp bn bx 
bn : du de dr ca dp cp 
bo : bt bq dv da dc 
bp : dt cq 
bq : bp bt cv 
br : cr 
bs : ca dk dc bo 
bt : dl cu 
bu : bq cv 
bv : ck cf db 
bw : db ds cj bp br 
bx : bs dr dp 
by : cz cb ci 
bz : ch do db 
ca : dh 
cb : cm cs 
cc : bu bw 
cd : ds ck dv bu cc 
ce : cy 
cf : bz 
cg : cy cd dl cv 
ch : ce 
ci : ds bw cc cd cs dg 
cj : do bv cf 
ck : do 
cl : bq dr bs dp bx 
cm : cg do 
cn : dl cx ca bm ct 
co : dd dq df 
cp : cz bs cl bx 
cq : du bt dt 
cr : cq bp cw 
cs : cg da 
ct : dg cc cj dm bm 
cu : cj dl 
cv : dv bw 
cw : ck 
cx : cu bq dn cz 
cy : ds cw 
cz : dg ci cb 
da : cm bt ch bz cr 
db : cw ds ch 
dc : dq du dt bz cs dh ca 
dd : di dj 
de : cx dc bs 
df : ds dq bp bx cp dd 
dg : cs br cb 
dh : cx da 
di : dl cn dj 
dj : db bv cq bx bm cn 
dk : dl by 
dl : du 
dm : do cb ca cc bo cp bn 
dn : cf dk 
do : 
dp : bo cx de dr 
dq : ds bw cq cr ca 
dr : dh bo de 
ds : ck cw 
dt : cu ds bt 
du : cj db 
dv : cf cq dl br bw 
