a : b d 
b : e 
c : e b 
d : c b 
e : 
f : j g h 
g : j 
h : g 
i : f h 
j : 
k : 
l : k o 
m : l n o 
n : k 
o : n 
p : 
q : s v 
r : u 
s : p 
t : s 
u : s q 
v : t p 
w : y bl bj 
x : bh 
y : x bf bc 
z : bc y 
ba : bi 
bb : be bk 
bc : bk x bg 
bd : x 
be : 
bf : bd bg bc 
bg : ba bd 
bh : ba 
bi : bb bk 
bj : bf bl 
bk : be 
bl : bg bi z 
bm : di bs bn 
bn : dg bu dv cm 
bo : dc 
bp : cm cb dq 
bq : di cq dm 
br : dm da bt dr 
bs : cp dm bt do dt 
bt : da 
bu : cs bq cq db dk 
bv : ci dd cx 
bw : bm dp 
bx : bo ck br dr 
by : br di cz cl 
bz : cf cl dd dh by 
ca : bt cv br cq bx 
cb : ci cx dd dq cl 
cc : df cu de dl 
cd : cj cn 
ce : bo cw 
cf : bq 
cg : dc ce cn cr 
ch : dv cm 
ci : bw ch co cx 
cj : ce cw ck 
ck : ce dc cw cn 
cl : da dk bm bv cx dq 
cm : cs dr dv 
cn : cw ce 
co : cr dc cg 
cp : di bx cw dr ca 
cq : cr do co 
cr : cd 
cs : bs ca 
ct : cy de cc 
cu : bq cy de dl 
cv : dc co db cq 
cw : bo 
cx : bq bu bn co bm bw 
cy : br cb by dn bz 
cz : ci ck dq df 
da : bo cg cf db 
db : ck co do cq 
dc : 
dd : db ci cx 
de : bz cy dl 
df : dh cj ds dr dp dn 
dg : bt dk ch cm 
dh : ds dn 
di : ce cv 
dj : ct 
dk : bs cj cs 
dl : dg dn cy 
dm : dc ce cv di 
dn : bp cl ds 
do : bo cn co 
dp : dg dt bn bm 
dq : bt du do 
dr : bt ck 
ds : bp cn cl 
dt : cj cf cp ca 
du : bv 
dv : dk bu br ck 
