a : b d 
b : e 
c : e b 
d : c b 
e : 
f : i 
g : h f 
h : i f 
i : 
j : h 
k : l 
l : o 
m : k n 
n : k 
o : 
p : v t 
q : s r 
r : s 
s : 
t : r s q v 
u : s r p 
v : q 
w : bg x 
x : bj bb bg 
y : bi w 
z : ba bf bl 
ba : x bh bb bc 
bb : bk bg 
bc : w bh 
bd : bi be 
be : 
bf : y ba 
bg : bk 
bh : bg w y x 
bi : bj 
bj : be 
bk : bd 
bl : bh y bd ba bb bc bf 
bm : cj dj cx cn 
bn : cf dm dr 
bo : cg 
bp : cl dv cd 
bq : cq 
br : cq bo 
bs : bn dn cy 
bt : bo br 
bu : cf dv cz 
bv : bx 
bw : bu di cd 
bx : cz cw co 
by : cy bn dl 
bz : cg cu 
ca : dv de ce dh 
cb : di dt dc 
cc : df dg cz cv do 
cd : cx bv di 
ce : cs bn cu cd 
cf : dk df 
cg : dv cp ds 
ch : cz bw cy cc dl do 
ci : dd dt 
cj : dm cg ca 
ck : bw 
cl : dq db dk cx 
cm : bt ct 
cn : cf cx dq bo bs dg 
co : cx bu dv cz 
cp : bp cx ds 
cq : 
cr : dm bp cp bt dr bn 
cs : cq cm 
ct : cu bz 
cu : df dk bo cr da 
cv : bm dl 
cw : cx bq 
cx : cq bq dk 
cy : dg cm 
cz : bq df dv 
da : cp bo co dr de bt bn cr 
db : bw ck dv 
dc : bp bs dd ci cv 
dd : dp 
de : cf cq dv br bt 
df : bq cw dk 
dg : bo br cj dr 
dh : cx dn 
di : bx co bv 
dj : by 
dk : bq cq 
dl : cw cu cn ct 
dm : ck cl de 
dn : ce 
do : cg bt cr cv 
dp : do ch bn cn 
dq : ck bv cw db cd 
dr : cp de dm 
ds : db bp 
dt : dp dd 
du : dr ch cn bv do cb 
dv : cx df cf 
