a : d b 
b : 
c : a 
d : 
e : a 
f : 
g : j i 
h : i j 
i : 
j : 
k : m l o 
l : 
m : o n 
n : o 
o : l 
p : r q 
q : v 
r : 
s : p 
t : s 
u : t 
v : r 
w : bh 
x : bj w bd 
y : bi 
z : bg 
ba : bd bl x bc bf 
bb : 
bc : w bi y 
bd : z 
be : bb 
bf : bl x bd 
bg : bl bj 
bh : be 
bi : be bk 
bj : bl w bk 
bk : w 
bl : y w bc 
