a : c 
b : d e 
c : e b 
d : b 
e : d c 
f : h 
g : h f 
h : i j 
i : j 
j : 
k : o 
l : 
m : l n 
n : o k 
o : l 
p : v 
q : t r 
r : u t 
s : 
t : s u 
u : s p 
v : s 
w : bk bc 
x : bi 
y : bb z bk bf bj 
z : bd be bj 
ba : bf bb bh 
bb : be bd 
bc : bk 
bd : bg w 
be : w bd 
bf : bg z 
bg : bc w 
bh : bj y 
bi : y bl 
bj : w bd bb 
bk : 
bl : ba 
