a : 
b : 
c : a 
d : c 
e : 
f : j i 
g : 
h : f i 
i : g 
j : i 
k : o n 
l : k 
m : l 
n : 
o : n 
p : u r t 
q : 
r : v u s 
s : v u 
t : r s 
u : v 
v : q 
w : dr 
x : z 
y : bg bh w bc 
z : w be 
ba : bj bh y bl 
bb : bh 
bc : bg 
bd : x 
be : w 
bf : bb bc y 
bg : bk 
bh : be bd bj 
bi : be bd bj w bh bb 
bj : bd 
bk : bd bb bi 
bl : bf 
bm : 
bn : ct cd 
bo : ci 
bp : cq 
bq : ca br 
br : da 
bs : da 
bt : 
bu : ck 
bv : 
bw : 
bx : 
by : bw 
bz : 
ca : bz 
cb : cr ch bs 
cc : 
cd : cv dp 
ce : 
cf : cd 
cg : 
ch : 
ci : 
cj : df 
ck : bp 
cl : cv 
cm : bv 
cn : 
co : 
cp : 
cq : co 
cr : cw 
cs : bx bn 
ct : 
cu : bq 
cv : db cg 
cw : 
cx : 
cy : 
cz : dg 
da : 
db : 
dc : bw 
dd : 
de : bz 
df : 
dg : 
dh : dg 
di : 
dj : dd 
dk : 
dl : bq 
dm : 
dn : 
do : db 
dp : 
dq : 
dr : ch 
ds : cq 
dt : cc 
du : dr 
dv : db 
