a : 
b : 
c : a 
d : c 
e : 
f : h g 
g : i h 
h : 
i : 
j : h 
k : 
l : k n m 
m : k 
n : k m 
o : l m 
p : r v 
q : p v u 
r : v 
s : v u q 
t : u q s 
u : p 
v : 
w : 
x : bi bg 
y : bk 
z : bb bc w 
ba : bg x 
bb : be bh bf 
bc : bd be y 
bd : bf 
be : y 
bf : y be 
bg : bi 
bh : y bc 
bi : bb bh z bj 
bj : bb 
bk : w 
bl : bk ba 
bm : dt dr dc bx 
bn : dj di 
bo : cf bu dm 
bp : cn dj de co 
bq : cv bw 
br : dq da 
bs : ck cm co cb 
bt : cd cy ca da 
bu : dv cr 
bv : cu cc co 
bw : dn ce dl cb cq 
bx : bn dj ca bo 
by : dc bz 
bz : dc 
ca : dn bs bp 
cb : bu co di 
cc : ci bz 
cd : bv cp 
ce : bo cn db 
cf : cy 
cg : dt cy cf by db 
ch : cu cd 
ci : dl bs bx 
cj : bt 
ck : dc by bu 
cl : dp bq dh 
cm : db bo bn 
cn : bz by 
co : de cg cm bz 
cp : db cb dr 
cq : br 
cr : dv 
cs : df ch 
ct : bo cv do 
cu : bm de cb dk 
cv : ch ds 
cw : bo cs cj dk ct 
cx : dn 
cy : 
cz : dd cr co 
da : di bm co ch 
db : cy cx 
dc : dt cf cx 
dd : cr bp dg do 
de : cn bn 
df : bn bw co du 
dg : ct cg cw bq do 
dh : cr bs de dg bq 
di : db dc by 
dj : dt dl 
dk : dr cp 
dl : ce 
dm : ck cx cg di 
dn : cf 
do : dm cq cv 
dp : di dn da dd 
dq : bt cr cj 
dr : cc dm 
ds : cu cs du 
dt : dn 
du : bz cj dq 
dv : cg cf cn di 
