a : c 
b : e d 
c : b d 
d : 
e : d 
f : 
g : h j i 
h : f j 
i : j h 
j : f 
k : l 
l : o 
m : o k 
n : l k m 
o : 
p : v r 
q : p u 
r : 
s : t q 
t : r 
u : r v p 
v : t 
w : bk z bd be 
x : y z bj be 
y : bf 
z : 
ba : bb bg bi 
bb : bj w 
bc : z ba 
bd : bj x be 
be : bf bj 
bf : bk 
bg : z 
bh : ba bf bl bd bi 
bi : bd bk bb 
bj : bf bk y 
bk : bg 
bl : be bd bc 
bm : cu ck cd cm ca 
bn : by cd 
bo : dt ce df 
bp : co cq 
bq : bu cx cg 
br : cs ct 
bs : bp br co dn dv ds 
bt : dc ch 
bu : cx bs 
bv : dj 
bw : cg du dm 
bx : du cn cu bw 
by : br cl 
bz : de cn bs 
ca : br cy dp dq cm 
cb : bq cf ch 
cc : bn dk bw cy 
cd : do cj cw 
ce : cz de 
cf : ck ci 
cg : bt cv cn cx bs bu 
ch : cw cv dc 
ci : dv cv bx 
cj : dj dl dd 
ck : cp cu di 
cl : cs co cq dh 
cm : dg dh cd cx cy dq 
cn : dh 
co : 
cp : cg dm cu di 
cq : co 
cr : ce di 
cs : bp co cn dn 
ct : cl 
cu : dk dm 
cv : co dv ds cw 
cw : ds bs 
cx : co ch cv cs br bt 
cy : cb 
cz : dc cc ca bm 
da : dl cg bn dd 
db : bq 
dc : ds br cv cw 
dd : dk bt db dl 
de : cs ch db 
df : cm cq de cr dr 
dg : bn cd dp 
dh : cq bp 
di : cu cj da 
dj : ds dv bz 
dk : ds do 
dl : dk bt cx 
dm : do da bn 
dn : cn bp 
do : bv cg 
dp : bs ck cd di 
dq : dg br bu ci cc 
dr : ce dt 
ds : ct dn by dv 
dt : bm dp cr 
du : cj bq cd dg 
dv : by dh ct 
