a : c 
b : e d 
c : b d 
d : 
e : d 
f : g 
g : j 
h : i 
i : 
j : h 
k : n 
l : n k 
m : k n o 
n : 
o : l 
p : s 
q : 
r : q u s t v 
s : q u 
t : p u 
u : q 
v : q p t 
w : 
x : bk bg bl 
y : bg x bc bj 
z : bj bi bf be 
ba : bh bc x 
bb : w 
bc : bl x 
bd : bg 
be : ba bj bi y 
bf : bi 
bg : bk w 
bh : w bl 
bi : x bh ba 
bj : x ba bc bf 
bk : bb 
bl : bd 
bm : bp cv 
bn : dv 
bo : de dn db 
bp : du bt 
bq : ca cp cr dk 
br : ca bp cc 
bs : de ck dj 
bt : bw dv cw bu dh 
bu : do cj 
bv : co cc 
bw : cf ch cb dt dm 
bx : bs br cz 
by : cf cx cd 
bz : cp db bx cr bo cz 
ca : dv di 
cb : by cy cc ch 
cc : ci bq bn cp dt 
cd : dl 
ce : dn dm cb bu bt cg 
cf : 
cg : dt bu 
ch : di bo bv 
ci : cy bn db bo cw 
cj : dt 
ck : cm dp ce 
cl : cn ch du 
cm : by dp bt 
cn : dm dj bz cz 
co : cw dr cc 
cp : cd da 
cq : dt cw du br cz bz dd 
cr : da de cp 
cs : bp cz br bm 
ct : bv dn dp cg ck 
cu : br cz do cq cv 
cv : bu bp df 
cw : cf bo dr cj 
cx : cf 
cy : dl by 
cz : di du bp br 
da : cf dr cy cd 
db : dk bq 
dc : ct dp ch cg bu ck dq 
dd : du ch dm cb bz bw dt ct cv cs 
de : da cp 
df : dn ck cl du 
dg : cn cq dd cu ds 
dh : dk bw cg 
di : bn 
dj : ce cg ck ct 
dk : bn de cr cp 
dl : ca 
dm : bv cb 
dn : by ca cy cp de db 
do : cp dk dm bw 
dp : dh cc do cg bt ce 
dq : dj bs 
dr : dv dl cy 
ds : bm cv cu 
dt : bo 
du : dq cj cr bs dc 
dv : cx 
