a : c 
b : e d 
c : b d 
d : 
e : d 
f : g 
g : j 
h : i 
i : 
j : h 
k : 
l : m 
m : k 
n : k m l 
o : l n 
p : u 
q : t r 
r : 
s : p v u t q 
t : v r 
u : v q 
v : r 
w : bl x bf 
x : z bg bk 
y : bh bd 
z : y bb 
ba : bb bl be bc 
bb : y 
bc : bi bj bl be 
bd : bh 
be : z bj 
bf : bd bg bl 
bg : y z bk bi 
bh : 
bi : bd z bk 
bj : bf bi w 
bk : z 
bl : x 
bm : 
bn : dh dc 
bo : dl 
bp : cr by bt 
bq : dr 
br : df 
bs : df 
bt : bn 
bu : cj 
bv : dg 
bw : dm db 
bx : 
by : 
bz : bw 
ca : 
cb : 
cc : ce 
cd : 
ce : dn ch 
cf : dd 
cg : cq 
ch : dd dh 
ci : by 
cj : bm 
ck : ct 
cl : 
cm : dj dd cd 
cn : cm cx df 
co : 
cp : du dj 
cq : cp 
cr : di 
cs : dd ci ce 
ct : 
cu : dq ct 
cv : cx cn bs 
cw : bz di 
cx : 
cy : cj 
cz : 
da : cx 
db : cb cs 
dc : 
dd : cl 
de : 
df : 
dg : bt cl dr 
dh : dv 
di : cv 
dj : 
dk : 
dl : by 
dm : di 
dn : br dm 
do : bn 
dp : cg 
dq : dn 
dr : cn du 
ds : 
dt : dp 
du : 
dv : 
