a : c 
b : e d 
c : b d 
d : 
e : d 
f : g 
g : j 
h : i 
i : 
j : h 
k : 
l : m 
m : k 
n : k m l 
o : l n 
p : u 
q : t r 
r : 
s : p v u t q 
t : v r 
u : v q 
v : r 
w : bi bd 
x : z bl 
y : bk bl bb ba 
z : bh y 
ba : bk bl 
bb : bl ba 
bc : w 
bd : bb bf be ba 
be : x bj 
bf : x y bj 
bg : 
bh : bg 
bi : bj ba 
bj : z bb 
bk : bg bh 
bl : bk 
ca : cp cl cz 
cp : dk 
ce : cl cc cf 
cl : dn 
dp : ch ds ci 
ch : ds 
by : ce dc 
cy : dg 
dg : bn 
cc : bz dl dc cf 
bz : db 
dd : bt cd cu 
bt : bv bm cx cm 
de : cz ck cb ci 
cz : dk cl cx 
df : bn dg 
bn : 
cw : bo ci 
bo : bw cn 
dv : df cj cs 
db : dt cn 
dt : dv bq bs cx 
ck : dl du 
da : du 
du : 
cg : dm 
dm : 
dl : du 
ds : ca co 
ct : cc 
cb : 
cj : dg dr 
bp : cp dn cx dt bx 
bv : dr ce 
dr : dl di 
dc : bw cv 
dh : dp cv 
ci : 
bs : dg bq dr dk cp 
cf : cq dc 
bm : bx bv 
bx : dn cp bs bu 
bq : dv dg 
bw : cj bq 
cv : ci dp 
dk : bw dl dn 
dn : cx 
cx : bw cs bo 
cq : 
br : dh 
dj : bw bs cn 
do : dh cq 
cd : 
cs : di dg cj 
bu : bq bs dt 
cn : bn bw 
cu : cb by dm cy 
dq : ct cr 
cr : de ct 
cm : bv bm 
di : 
co : 
