a : d b 
b : 
c : a 
d : 
e : a 
f : 
g : j i 
h : i j 
i : 
j : 
k : m l o 
l : 
m : o n 
n : o 
o : l 
p : r q 
q : v 
r : 
s : p 
t : s 
u : t 
v : r 
w : y ba bc 
x : bd bj bg bh bc 
y : bg be 
z : bf 
ba : bl y 
bb : bf z 
bc : bd z 
bd : be y 
be : bj 
bf : 
bg : z bb be 
bh : z bj bg bc 
bi : x bg 
bj : bb 
bk : bi be bh 
bl : bi bk 
bm : di cz ci cy cd df 
bn : cw 
bo : do db bu 
bp : bw bo br bv 
bq : dg cs ca di 
br : cq do dg 
bs : dv dp 
bt : bo bn cm 
bu : cp cj df cx db 
bv : cz cq df br 
bw : cr dl 
bx : 
by : dc bq cu cz 
bz : br bv de cv 
ca : cc 
cb : cl cg cf 
cc : dk dj dv cp do 
cd : dd by cy cx 
ce : bv br de bz 
cf : dr da ci cx bz ct 
cg : cr ci 
ch : de bq cf cx ct 
ci : cr dj cs 
cj : cu dc cz by 
ck : cd bz bm co 
cl : ds 
cm : br bp cv ce bz 
cn : cl bt cb 
co : db dh 
cp : bx bs dm 
cq : db bu bo 
cr : bs 
cs : bx cr dl bw 
ct : di dr da 
cu : ca du 
cv : de bw 
cw : ch 
cx : di bq 
cy : dd 
cz : ca dg dc ci cu 
da : dr de 
db : cd bm df 
dc : cs dm cc do bq cx 
dd : cj du by 
de : br bp bv 
df : cd 
dg : bw cg 
dh : cy bp bt 
di : dn dq ca 
dj : dm cp bw 
dk : dn cs dv 
dl : dp cr 
dm : dl cs bw 
dn : cg dm bw dq 
do : dn bx dk 
dp : dv 
dq : dg dp dj 
dr : dt bv 
ds : db da ck 
dt : cm bv bz 
du : di dc 
dv : bx 
