a : c 
b : 
c : b d 
d : b 
e : b d a 
f : 
g : i 
h : g f 
i : 
j : i 
k : m 
l : n 
m : n l 
n : 
o : m n k 
p : q t u 
q : s 
r : 
s : r 
t : s q u v 
u : q s v 
v : r s q 
w : z ba 
x : z bd 
y : bh bg 
z : bl 
ba : bl x bd 
bb : bh bf be bj 
bc : be bb bj 
bd : z 
be : bh bg bf 
bf : y bj 
bg : ba bd bi bh 
bh : bd bi 
bi : z w 
bj : w y bg 
bk : bh bc w 
bl : 
