a : c 
b : 
c : b d 
d : b 
e : b d a 
f : 
g : i 
h : g f 
i : 
j : i 
k : m 
l : n 
m : n l 
n : 
o : m n k 
p : u q s 
q : r s 
r : u 
s : t u r 
t : r 
u : 
v : p 
w : bb 
x : bh 
y : be ba x 
z : bf bh 
ba : bc 
bb : bj ba 
bc : bk bi bj 
bd : 
be : bj bk w ba 
bf : y bg bh 
bg : bk ba bi bb be 
bh : bg bl 
bi : bd bk 
bj : bd 
bk : bj 
bl : be bg 
