a : c d 
b : e 
c : b 
d : c 
e : 
f : 
g : f j 
h : g 
i : f g j h 
j : f 
k : m 
l : n o 
m : 
n : m k o 
o : k 
p : r t 
q : r t p 
r : 
s : q p u 
t : r 
u : r q 
v : q p t u s 
w : bb bl bg 
x : bd bg 
y : 
z : bk bg 
ba : bi bh 
bb : bi bg 
bc : bd bg w be 
bd : bk z 
be : x bf 
bf : bd bl 
bg : y 
bh : w bc 
bi : bf x be 
bj : bb be bl w bc ba 
bk : y bg 
bl : y z bd bg x 
