a : c d 
b : e 
c : b 
d : c 
e : 
f : 
g : f 
h : g 
i : f g h 
j : g h i 
k : n l 
l : 
m : k o 
n : l 
o : k n 
p : q 
q : 
r : v s 
s : p 
t : q p r 
u : r s t 
v : p s 
w : bi bk bj x be 
x : bi bh ba 
y : 
z : bh bk 
ba : bd bi 
bb : bf bj bh 
bc : y bk bd bl 
bd : bh z 
be : ba bh bk x 
bf : y 
bg : y bf 
bh : bf bj 
bi : bl bc 
bj : bg bf 
bk : bb y 
bl : bd 
