a : c d 
b : e 
c : b 
d : c 
e : 
f : 
g : f 
h : g 
i : f g h 
j : g h i 
k : n l 
l : 
m : k o 
n : l 
o : k n 
p : 
q : p r s 
r : p 
s : r 
t : p q 
u : v s q 
v : t q 
w : bl bb 
x : bh bc 
y : bh x 
z : bg 
ba : be bj bd 
bb : bc bl 
bc : bi 
bd : bi w z bj 
be : bf 
bf : y bb w x 
bg : bk 
bh : bi bc 
bi : 
bj : x be z 
bk : x be 
bl : bc x y 
