a : c d 
b : a 
c : d 
d : 
e : b 
f : g 
g : j 
h : g i f 
i : 
j : i 
k : m o l 
l : o m 
m : 
n : k l 
o : m 
p : s u 
q : p 
r : s q 
s : u 
t : q r 
u : 
v : t 
w : bh 
x : bd bj bk bf 
y : 
z : bh bc 
ba : bb bg 
bb : z bh bk bj bc bd 
bc : w 
bd : w bc z 
be : bf x 
bf : w bd bb 
bg : be 
bh : y 
bi : bk bg x ba 
bj : w z bd bk 
bk : bc bd 
bl : y bj be bi ba 
